11101101100110
01111001001100
11000001111001
10000011001111
00001110101101
10000101101000
11101110101000
10101000111000
00111000110000
