0101111101
1011001000
1101001111
0101110001
0011011100
0101100110
1111100000
0101011011
1000000100
