00000111110100
00000100000100
01111101111100
01001000011000
11111110001111
00000010001000
00111111111000
00100001001000
00110011100000
