1011000101
1100000011
0111111100
0000010100
1111010110
0001011010
0111010110
0001010011
0101100100
