0110000111
1100011100
0111110000
0000011110
1101001011
0001101000
0000111111
1111101000
0101000000
