1000110000
1011100011
0000100010
1111110011
0010001101
1110110000
1000111111
1111010001
0001110000
