1110000111
0000001101
0110000001
0100110000
1111010000
0101111101
0011100100
0110100110
0000000011
