00000000000000
00000111111000
00111100001100
01101111000111
01001001100100
00001000110100
00001000111000
11011101001100
01110110000000

