1010100100
0011100101
1110101110
1010010000
1011111011
0011000100
0101000001
1101111011
0010101110
