00011000011110
01110001110010
01011111000010
01000001111000
11110100101111
01000110100000
01000011111100
01111110100000
00010100000000
