1000001001
1001111100
1011001011
1010111010
0010101010
0110100110
1110111101
0100100001
0001000001
