00001110000000
11111010111000
01000010101000
01110011101000
00011000000000
00001111011000
01111010000000
00010011111111
00011000000000
