01111000011100
11000000110100
10011000000110
00010011000011
01111101000001
11010111110110
00001110010010
00011010011011
00000000001110
