0000000000
0001111110
1111000011
1011110001
0010011001
0010001101
0010001110
0111010011
1101100000

