10000001000000
11000001110000
01111101011111
00001000010000
00001001111100
00111000100110
00101000100000
00101101111100
00110111001000
