0001111101
0001000001
1111011111
0010000110
1111100011
0000100010
1111111110
1000010010
1100111000
