0000010000
0000011100
1111010111
0010000100
0010011111
1110001001
1010001000
1011011111
1101110010
