0011100000
1110101110
0000101010
1100111010
0110000000
0011110110
1110100000
0100111111
0110000000
