0001110011
0011011001
0110110101
0011011100
0110001000
0100001011
0100011110
1101000000
1010110011
