0110111000
1010110011
1111101011
0101001010
0001100101
0000101111
0100111000
1111011000
0100010110
