0010101101
1000000001
1111011101
0101110011
1001110000
0001011101
0011001000
0010101000
0101011111
