1011011001
1110010011
0000011110
0000110011
0011101011
0001011010
1011101010
1010001110
1110001100
